"filename", "language", "Python", "Markdown", "XML", "TypeScript JSX", "JSON", "comment", "blank", "total"
"c:\dev-fg\GPT-Games\Tactic\Animation.py", "Python", 154, 0, 0, 0, 0, 21, 44, 219
"c:\dev-fg\GPT-Games\Tactic\Boat.py", "Python", 92, 0, 0, 0, 0, 14, 23, 129
"c:\dev-fg\GPT-Games\Tactic\BuildTeam.py", "Python", 543, 0, 0, 0, 0, 15, 106, 664
"c:\dev-fg\GPT-Games\Tactic\Bullet.py", "Python", 54, 0, 0, 0, 0, 2, 11, 67
"c:\dev-fg\GPT-Games\Tactic\ConnectToServer.py", "Python", 57, 0, 0, 0, 0, 3, 16, 76
"c:\dev-fg\GPT-Games\Tactic\Connection.py", "Python", 198, 0, 0, 0, 0, 26, 43, 267
"c:\dev-fg\GPT-Games\Tactic\DashedLine.py", "Python", 45, 0, 0, 0, 0, 6, 22, 73
"c:\dev-fg\GPT-Games\Tactic\Database.py", "Python", 18, 0, 0, 0, 0, 1, 9, 28
"c:\dev-fg\GPT-Games\Tactic\Encryption.py", "Python", 50, 0, 0, 0, 0, 0, 8, 58
"c:\dev-fg\GPT-Games\Tactic\Game.py", "Python", 382, 0, 0, 0, 0, 31, 82, 495
"c:\dev-fg\GPT-Games\Tactic\GraphicUI.py", "Python", 740, 0, 0, 0, 0, 85, 201, 1026
"c:\dev-fg\GPT-Games\Tactic\Helicopter.py", "Python", 154, 0, 0, 0, 0, 14, 29, 197
"c:\dev-fg\GPT-Games\Tactic\Inputs.py", "Python", 44, 0, 0, 0, 0, 4, 7, 55
"c:\dev-fg\GPT-Games\Tactic\Item.py", "Python", 16, 0, 0, 0, 0, 0, 3, 19
"c:\dev-fg\GPT-Games\Tactic\Lobby.py", "Python", 67, 0, 0, 0, 0, 5, 18, 90
"c:\dev-fg\GPT-Games\Tactic\MainFrame.py", "Python", 223, 0, 0, 0, 0, 10, 46, 279
"c:\dev-fg\GPT-Games\Tactic\MusicPlayer.py", "Python", 14, 0, 0, 0, 0, 4, 8, 26
"c:\dev-fg\GPT-Games\Tactic\PlankAndBall (2).py", "Python", 209, 0, 0, 0, 0, 43, 43, 295
"c:\dev-fg\GPT-Games\Tactic\PlankAndBall.py", "Python", 207, 0, 0, 0, 0, 43, 44, 294
"c:\dev-fg\GPT-Games\Tactic\Player.py", "Python", 40, 0, 0, 0, 0, 4, 11, 55
"c:\dev-fg\GPT-Games\Tactic\PlayerAI.py", "Python", 95, 0, 0, 0, 0, 5, 19, 119
"c:\dev-fg\GPT-Games\Tactic\RandomEvents.py", "Python", 274, 0, 0, 0, 0, 17, 92, 383
"c:\dev-fg\GPT-Games\Tactic\Soldier.py", "Python", 317, 0, 0, 0, 0, 30, 78, 425
"c:\dev-fg\GPT-Games\Tactic\Tank.py", "Python", 93, 0, 0, 0, 0, 17, 26, 136
"c:\dev-fg\GPT-Games\Tactic\Unit.py", "Python", 570, 0, 0, 0, 0, 58, 150, 778
"c:\dev-fg\GPT-Games\Tactic\Utils\imageResizer.py", "Python", 23, 0, 0, 0, 0, 8, 10, 41
"c:\dev-fg\GPT-Games\Tactic\Utils\imageSplit.py", "Python", 23, 0, 0, 0, 0, 13, 8, 44
"c:\dev-fg\GPT-Games\Tactic\Utils\lsprofcalltree.py", "Python", 100, 0, 0, 0, 0, 9, 24, 133
"c:\dev-fg\GPT-Games\Tactic\Utils\rename.py", "Python", 14, 0, 0, 0, 0, 11, 10, 35
"c:\dev-fg\GPT-Games\Tactic\Vector2D.py", "Python", 83, 0, 0, 0, 0, 23, 30, 136
"c:\dev-fg\GPT-Games\Tactic\assets\maps\harbor.tsx", "TypeScript JSX", 0, 0, 0, 215, 0, 0, 1, 216
"c:\dev-fg\GPT-Games\Tactic\assets\maps\helipad.tsx", "TypeScript JSX", 0, 0, 0, 9, 0, 0, 1, 10
"c:\dev-fg\GPT-Games\Tactic\assets\maps\menu.tmx", "XML", 0, 0, 61, 0, 0, 0, 1, 62
"c:\dev-fg\GPT-Games\Tactic\assets\maps\mergeTiles.py", "Python", 39, 0, 0, 0, 0, 3, 14, 56
"c:\dev-fg\GPT-Games\Tactic\assets\maps\merged_all.tsx", "TypeScript JSX", 0, 0, 0, 1489, 0, 0, 1, 1490
"c:\dev-fg\GPT-Games\Tactic\assets\maps\small_house3_color1.tsx", "TypeScript JSX", 0, 0, 0, 4, 0, 0, 1, 5
"c:\dev-fg\GPT-Games\Tactic\assets\maps\terrain1.tmx", "XML", 0, 0, 54, 0, 0, 0, 1, 55
"c:\dev-fg\GPT-Games\Tactic\assets\maps\terrain2.tmx", "XML", 0, 0, 68, 0, 0, 0, 1, 69
"c:\dev-fg\GPT-Games\Tactic\assets\maps\tree1.tsx", "TypeScript JSX", 0, 0, 0, 4, 0, 0, 1, 5
"c:\dev-fg\GPT-Games\Tactic\assets\maps\tree2.tsx", "TypeScript JSX", 0, 0, 0, 4, 0, 0, 1, 5
"c:\dev-fg\GPT-Games\Tactic\assets\maps\tree3.tsx", "TypeScript JSX", 0, 0, 0, 4, 0, 0, 1, 5
"c:\dev-fg\GPT-Games\Tactic\assets\maps\trees.tsx", "TypeScript JSX", 0, 0, 0, 4, 0, 0, 1, 5
"c:\dev-fg\GPT-Games\Tactic\assets\walking.tsx", "TypeScript JSX", 0, 0, 0, 34, 0, 0, 1, 35
"c:\dev-fg\GPT-Games\Tactic\atlas-starter.py", "Python", 54, 0, 0, 0, 0, 38, 24, 116
"c:\dev-fg\GPT-Games\Tactic\box.py", "Python", 63, 0, 0, 0, 0, 12, 24, 99
"c:\dev-fg\GPT-Games\Tactic\client.py", "Python", 26, 0, 0, 0, 0, 2, 8, 36
"c:\dev-fg\GPT-Games\Tactic\config.py", "Python", 106, 0, 0, 0, 0, 2, 20, 128
"c:\dev-fg\GPT-Games\Tactic\data\countries.json", "JSON", 0, 0, 0, 0, 1668, 0, 0, 1668
"c:\dev-fg\GPT-Games\Tactic\data\country-names.json", "JSON", 0, 0, 0, 0, 207, 0, 1, 208
"c:\dev-fg\GPT-Games\Tactic\data\names-male.json", "JSON", 0, 0, 0, 0, 1, 0, 0, 1
"c:\dev-fg\GPT-Games\Tactic\data\player.json", "JSON", 0, 0, 0, 0, 1, 0, 0, 1
"c:\dev-fg\GPT-Games\Tactic\data\unitSettings.json", "JSON", 0, 0, 0, 0, 202, 0, 0, 202
"c:\dev-fg\GPT-Games\Tactic\data\userSettings.json", "JSON", 0, 0, 0, 0, 4, 0, 0, 4
"c:\dev-fg\GPT-Games\Tactic\grid - Copy.py", "Python", 398, 0, 0, 0, 0, 69, 114, 581
"c:\dev-fg\GPT-Games\Tactic\grid.py", "Python", 447, 0, 0, 0, 0, 75, 132, 654
"c:\dev-fg\GPT-Games\Tactic\instructions.md", "Markdown", 0, 26, 0, 0, 0, 0, 29, 55
"c:\dev-fg\GPT-Games\Tactic\instructions.py", "Python", 87, 0, 0, 0, 0, 6, 26, 119
"c:\dev-fg\GPT-Games\Tactic\intersect.py", "Python", 89, 0, 0, 0, 0, 45, 38, 172
"c:\dev-fg\GPT-Games\Tactic\letterColor.py", "Python", 51, 0, 0, 0, 0, 10, 17, 78
"c:\dev-fg\GPT-Games\Tactic\menu.py", "Python", 112, 0, 0, 0, 0, 1, 27, 140
"c:\dev-fg\GPT-Games\Tactic\path.py", "Python", 44, 0, 0, 0, 0, 15, 15, 74
"c:\dev-fg\GPT-Games\Tactic\plank.py", "Python", 124, 0, 0, 0, 0, 10, 37, 171
"c:\dev-fg\GPT-Games\Tactic\plank2.py", "Python", 234, 0, 0, 0, 0, 31, 43, 308
"c:\dev-fg\GPT-Games\Tactic\server.py", "Python", 144, 0, 0, 0, 0, 12, 36, 192
"c:\dev-fg\GPT-Games\Tactic\stick-man copy.py", "Python", 318, 0, 0, 0, 0, 37, 103, 458
"c:\dev-fg\GPT-Games\Tactic\stick-man.py", "Python", 191, 0, 0, 0, 0, 25, 64, 280
"c:\dev-fg\GPT-Games\Tactic\stick-man2.py", "Python", 40, 0, 0, 0, 0, 8, 11, 59
"c:\dev-fg\GPT-Games\Tactic\stick-man3.py", "Python", 906, 0, 0, 0, 0, 84, 147, 1137
"Total", "-", 8372, 26, 183, 1767, 2083, 1007, 2163, 15601